W W W W W W W W W W W W W W W W W W W W W W W W W W W W W W
W C C C C C C C C C C C C W W C C C C C C C C C C C C W W W
W C W W W W C W W W W W C W W C W W W W W C W W W W C W W W
W S W W W W C W W W W W C W W C W W W W W C W W W W S W W W
W C W W W W C W W W W W C W W C W W W W W C W W W W C W W W
W C C C C C C C C C C C C C C C C C C C C C C C C C C W W W
W C W W W W C W W C W W W W W W W W C W W C W W W W C W W W
W C W W W W C W W C W W W W W W W W C W W C W W W W C W W W
W C C C C C C W W C C C C W W C C C C W W C C C C C C W W W
W W W W W W C W W W W W P W W P W W W W W C W W W W W W W W
W W W W W W C W W W W W P W W P W W W W W C W W W W W W W W
W W W W W W C W W P P P V V V V P P P W W C W W W W W W W W
W W W W W W C W W P W W W W W W W W P W W C W W W W W W W W
W W W W W W C W W P W H H H H H H W P W W C W W W W W W W W
P P P P P P C P P P W H H H H H W P P P P C P P P P P P P P
W W W W W W C W W P W H H H H H H W P W W C W W W W W W W W
W W W W W W C W W P W W W W W W W W P W W C W W W W W W W W
W W W W W W C W W P P P P P P P P P P W W C W W W W W W W W
W W W W W W C W W P W W W W W W W W P W W C W W W W W W W W
W W W W W W C W W P W W W W W W W W P W W C W W W W W W W W
W C C C C C C C C C C C C W W C C C C C C C C C C C C W W W
W C W W W W C W W W W W C W W C W W W W W C W W W W C W W W
W C W W W W C W W W W W C W W C W W W W W C W W W W C W W W
W S C C W W C C C C C C C B P C C C C C C C W W C C S W W W
W W W C W W C W W C W W W W W W W W C W W C W W C W W W W W
W W W C W W C W W C W W W W W W W W C W W C W W C W W W W W
W C C C C C C W W C C C C W W C C C C W W C C C C C C W W W
W C W W W W W W W W W W C W W C W W W W W W W W W W C W W W
W C W W W W W W W W W W C W W C W W W W W W W W W W C W W W
W C C C C C C C C C C C C C C C C C C C C C C C C C C W W W
W W W W W W W W W W W W W W W W W W W W W W W W W W W W W W